0#####0
##p00##
#00#00#
#0bxb0#
#00g00#
##0g0##
0#####0