######00
#p000##0
#0bb00#0
#0#g0g#0
#00000#0
#######0
00000000
00000000