######0
#p000##
#0bb00#
#0#g0g#
#00000#
#######
