#####000
#p00##00
#gbx0#00
#00#0#00
#0000#00
######00
00000000
00000000