#####000
#000#000
#0#0###0
#xgb00#0
#00#b0#0
#p000g#0
#######0
00000000