#####0
#p00##
#gbx0#
#00#0#
#0000#
######