#####00
#000#00
#0#0###
#xgb00#
#00#b0#
#p000g#
#######