######00
#px00##0
#0b#00#0
#0b0g0#0
#g000##0
######00
00000000
00000000