######0
#p0gg#0
#0#b00#
#0#000#
#00b#0#
#00x00#
#######