######0
#gpx0##
#b00b0#
#000#0#
#00g00#
#######