######00
#gpx0##0
#b00b0#0
#000#0#0
#00g00#0
#######0
00000000
00000000