######
#p000#
#00bg#
#0gb0#
######