0#####00
##p00##0
#00#00#0
#0bxb0#0
#00g00#0
##0g0##0
0#####00
00000000