######00
#00g0#00
#0#g0##0
#00g00#0
#0bbb0#0
#00#0p#0
#######0
00000000