######00
#p0gg#00
#0#b00#0
#0#000#0
#00b#0#0
#00x00#0
#######0
00000000