0#######
##p##gg#
#0bb0bg#
#000b00#
####00g#
000#####