######00
#0000###
#000gg0#
#0bbbp0#
#00#0g0#
########