######00
#p000#00
#00bg#00
#0gb0#00
######00
00000000
00000000
00000000