  ####
###00#
#p0gb##
#000b0#
#0#g00#
#00000#
#######