######00
#00p0#00
#b####00
#0#00000
#g#00000
###00000
00000000
00000000