0#####00
##g00###
#00#0bp#
#00#0#0#
#0x00bg#
#0000###
######00
00000000