0######0
##0000##
#0gg000#
#0#0bbb#
#000#pg#
########