00####00
###00#00
#p0gb##0
#000b0#0
#0#g00#0
#00000#0
#######0
00000000