00#####0
###000#0
#gpb00#0
###0bg#0
#g##b0#0
#0#0g0#0
#b0xbbg#
#000g00#
########