00#####0
###00p#0
#g0x#0#0
#000b0#0
#0bg0##0
######00
00000000
00000000