###0#0##
#g#p####
###0#0##
#000000#
#000000#
#000000#
#00b000#
########