000#####
####000#
#gg#b#0#
#0000b0#
#gb00#p#
#ggbb#0#
####000#
000#####