######0
#00g0#0
#0#g0##
#00g00#
#0bbb0#
#00#0p#
#######