00####00
00#00#00
###pb#00
#0bbg##0
#0bgg0#0
#0bgg0#0
#000###0
#####000