0000####
00##000#
###0000#
#g00b#p#
#ggb0b0#
###g0b0#
00###00#
0000####